perantauantolonglah : perantauan tolonglah
ahhhh : ah
donkpak : dong pak
prabowosemoga : prabowo semoga
anjing : umpatan
bantenbrgaji : banten bergaji 
prushaan: perusahaan
brsdh th : sudah tahun
presidenkumantap : presidenku mantap
tlong : tolong
sanakeadilannya : sana keadilannya
minimwajar : minim wajar
artinyaa : artinya
hy : hanya
smntara : sementara
besarbesaran : besar-besaran
kamisemoga : kami semoga
brppn : berapapun
susulmenyususl : susul menyususl
naikfaktanya : naik faktanya
diindonesiamalah : di indonesia malah
bangsanyatapi : bangsanya tapi
smoga : semoga
knaikan : kenaikan
singgel : single
percumabiaya : percuma biaya
minusmakan : minus makan
drastisgaji : drastis gaji
ribuapalagi : ribuapalagi
anakpertalite : anak pertalite
ribukos : ribu kos
rmisi : misi
sebage : sebagai
jateng : jawa tengah
pakbrjangan : pak jangan
koruptorquotindonesia : koruptor quot indonesia
berkalikalo : berkali kalo
brtapi : tapi
nma : nama
smpk : sampai
blom : belum
terimakasih : terima kasih
paksaya : pak saya
jngn : jangan
terealisasibravo : terealisasi bravo
upahkalo : upah kalo
bansosbltbantuan : banso bantuan
poko : pokok
upahhanya : upah hanya
batuan : bantuan
bagamana : bagaimana
lpanagn : lapangan
bnyak : banyak
buwat : buat
pajaknya : pajak nya
bonekane : bonekanya
pokoksupaya : pokok supaya
pakk : pak
sellu : selalu
wkwkwk : tertawa
pakcapek : pak capek
dendftr : mendaftar
dipertimbanganya : di pertimbanganya
subiantojgn : subianto jangan
krrja : kerja
sawitsahangkarettimah : sawit sahang karet timah
yha : ya
dlldllbelum : dan lain lain belum
jelasterus : jelas terus
pemerintahanterakhir : pemerintahan terakhir
semuatahun : semua tahun
framebrbikin : frame bikin
sihbr : sih
siapsiap : siap-siap
temantemanbrjangan : teman-teman jangan
ajedi : aja di
vendorpekerja : vendor pekerja
trmksih : terima kasih
nasip : nasib
bowokmu : bowo kamu
brbrkenaikan : kenaikan
potensialbrbr : potensial
btekanan : teakanan
produksib : produksi
operasionalbrbr : operasional
pendapatanbrbr : pendapatan
ekonomib : ekonomi
rendahbrbr : rendah
domestikb : domestic
sosisalb : sosial
listrikdll : listrik dan lain lain
pnsbrcukup : pns cukup
upahbrbiar : upah biar
trimksh : terima kasih
brhanya : hanya
naikbrimpas : impas
naikbrsubsidi : naik subsidi
dicabutbrppn : dicabut ppn 
kaliankalian : kalian
singapurabrunai : singapura brunai
tinggix : tinggi
inijd : ini jadi
kerjaxyg : kerja yang
skaliklo : sekali kalua
tlg : tolong
boronganx : borongan
industrijd : industri jadi
mnikmati : menikmati
itupemerintah : itu pemerintah
adilksian :  adil kasian
dllu : dulu 
gurupns : guru pns
snbrnya : sebenarnya
naeknhya : naiknya
sdang : sedang
naek : naik
boong : bohong, 
prabowohashim : prabowo hashim
kejepityg : kejepit yang
sulitburuh : sulit buruh
sedikitgaji : sedikit gaji
tinggimakanya : tinggi makanya
sjbiar : saja biar
butaenak : buta enak
ajamereka : aja mereka
prabowoanggota : prabowo anggota
dprkeluarga : dpr keluarga
gampangjadi :  gampang jadi
kalu : kalua
tetep : tetap
presidnt : presiden
krna : karena
pmikira : pemikiran
terbarukn : terbarukan
trhebat : terhebat
dikendalikn : di kendalikan
ksihani : kasihani
hatihati : hati-hati
mudahmudahan : mudah-mudahan
pegawe : pegawai
apaapa : apa-apa
brbravo : bravo
copotganti : copot ganti
setujumendukung : setuju mendukung
per : pak
muaminkok : muamin kok
iniisya : insya
brpns : pns 
brnasib : nasib
brgaji : gaji
president : presiden
boon : bohong
ehh : eh
manusiabrbrmengumumkan : manusia mengumumkan
indonesiabrbrsaya : indonesia saya
brdi : di
brsampai : sampai
inibrpajak : ini pajak
pajarbrgaji : pajak gaji
guysbrsaya : guys saya
tahunbrdan : tahun dan
pppktahap : ppk tahap
brsedangkan : sedangkan
kbrjika : kabar jika
paksudah : pak sudah
sendiriboro : sendiri
umpblum : ump belum
pengsiun : pension
tmpat : tempat sedirbrhapuskan : sediri hapuskan
buruhbrbuat : buruh buat
dilapanganyakita : dilapangannya kita 
bsar : besar
trunkan : turunkan
brbrindahnya : indahnya
brapa : berapa
indonesiapropinsikabupatenkota : indonesia provinsi kabupaten kota
padhl : padahal
dilantikngeri :  dilantik ngeri
agr : agar
uanv : uang
sbrhampir : hamper
trahir : terakhir
prabowotolong : prabowo tolong
flattbrjakarta : flat Jakarta
bossssbrdaerah : bos daerah
bozzzzbrharga : bos Harga
bozzz : bos
brini :ini
jojowi : jokowi
naikbrkesimpulannya : naik kesimpulannya
brdan : dan
pajakbrya : pajak ya
tolonh : tolong
benartidakphp : benar tidak php
puyengrakyat : pusing rakyat
pengusahakecil : pengusaha kecil
umptrus : ump terus
wkwkwkwkwkwk : tertawa
sampaikanbrbrtolong : sampaikan tolong
peraturanbrbrsoalnya : peraturan soalnya
alhamdullillahbersukur : alhamdullillah bersyukur
jari : hari
rb : ribu
hxhxh : tertawa
sekarangquothobinya : sekarang hobinya
bagamana : bagaimana
dipabrikpercuma : di pabrik percuma
hasilx : hasilnya
anblnburuh :bulan buruh
daerahyg : daerah yang
smentara : sementara
bnyak : banyak
dbawah : dibawah
jomplangnya : perbedaanya
jauhyg : jauh yang
smakin : semakin
jateng : Jawa Tengah
nang : yang
amp : sampai
teruuuuuuussssss : terus
nyanegara : nya negara
kacung : pesuruh
brnyatanya : nyatanya
sesuaiaku : sesuai aku
yaah : yah
famly : keluarga
nihh : nih
swerrr : serius
yaaa : ya
mumed : pusing
lisyrik : listrik
ohhh : oh
enack : enak
swarranya : suaranya
wkwkwkwkbrsebentar : tertawa sebentar
wkwkwkbrminta : tertawa minta
kecilmisinpetani : kecil misin petani
dihawairkn : di khawatirkan
sejahterakarna : sejahtera karena
nyabhkn : nya bahkan
jokow : jokowi
brmaka : maka
yerima : terima
alihterpaksa : alih terpaksa
pwngusha : pengusha
swperti : seperti
negarabryx : negara nya
yx : nya
zmn : jaman
mnjdikam : menjdikan
peghsl : penghasil
vaksinbooster : vaksin booster
mundurbr : mundur
menaexkan : menaikkan
naex : naik
rupiyah : rupiah
tigal : tinggal
wujotnya : wujudnya
dilanjot : dilanjut
hanjor : hancur
upahkita : upah kita
negaranunggu : negara nunggu
apimereka : api mereka
enakpejabat : enak pejabat
kewarungjadi : kewarung jadi
kitatp : kita tapi
skrang : sekarang
kebutuhanbrtapi : kebutuhan tapi
kebutuhandan : kebutuhan dan
datangbr : datang
doank : doang
jtbulan : juta bulan
naikbrppn : naik berapapun
naikbrapa : naik berapa
enaknua : enaknya
gx : tidak
bjasa : jasa
perhatiinmentang : perhatiin mentang
parahbryg : parah yang
pgn : ingin
bulanmemanfaatkan : bulan memanfaatkan
setujupj : setuju
acan : sama sekali
maapkandang : maaf kandang
alhamdulillahngomong : alhamdulillah ngomong
bropnskartu : bro pns kartu
maeeen : main
kecilmasuk : kecil masuk
barangnyabiar : barangnya biar
rugiiii : rugi
boooong : bohong
naikjadi : naik jadi
naikpun : naik pun
jmlh : jumlah
pnddk : penduduk
brgubernur : gubernur
brtindak : bertindak
brjgn : jangan
omon : bicara
bringeet : ingat
gkusah : tidak usah
boss : bos
naikkk : naik
standr : standar
rbdiabwah : dibawah
capenyh : capek nya
gjipekerja : gaji pekerja
masyarakt : masyarakt
tapu : tapi
pemerintahbrdi : pemerintah di
sepirugi : sepi rugi
donktiap : dong tiap
gajhn : gajian
bodohigak : bodohi tidak
indonezia : Indonesia
amanpasti : aman pasti
betahindo ezia : betah Indonesia
kayajanggan : kaya jangan
takuttjanggan : takut jangan
dengger : dengar
omonggan : omongan, asingg : asing
imbasnyatetep : imbasnya tetap
umrkarena : umr karena
pabrikgaji : pabrik gaji
jtamohon : juta mohon
pemerintahkami : pemerintah kami
kariawan : karyawan
hapusuud : hapus uud 
demodemo  : demo-demo
buarin : bubarin
pemerintahga : pemerintah tidak
barangitu : barang gitu
jkowidapat : jokowi dapat
kemudahandapat : kemudahan dapat
omniguslaw : omnibuslaw
dlldll : lainnya
kwkwk : tertawa
umpbrbahkan : ump bahkan
terwjudmudah : terwujud mudah
tetapkansering : tetapkan sering
perusahaanbukan : perusahaan bukan
tahunbrudah : tahun udah
jta : juta
brkaena : karena 
kebutah : kebutuhan 
brga : tidak
kerjabrbrpiye : kerja apa
wkwkwk : tertawa
karyawannyabanyak : karyawan banyak
perisaahan : perusahaan 
lainsatgas : lain satgas
pragib : prabowo gibran
asetklo : aset kalau
haduhhh : aduh
terys : terus 
nggk : tidak 
ngromed : tidak terawat
ngecapruk : berserakan
orng : orang
msih : masih
nyawana : nyawanya
klau : kalau 
sujabumi : sukabumi
pengangguransebaiknya : pengangguran sebaiknya
nanem : tanam
naikpercuma : naik percuma
donkktpi : dong tapi
doank : doang
sembko : sembako
namaduit : nama duit
ojolbrpasti : ojol pasti
tahunkrn : tahun karena
dmna : dimana
siyapphk : siap phk 
besartapi : besar tapi 
selamatkalau : selamat kalau
melonjakpeceraiyan : melonjak peceraiyan
hatidengan : hati dengan
konglomeratpengusaha : konglomerat pengusaha
jokowe : jokowi
tudak : tidak
phkbrmenunju : phk menuju
apaka : apakah
phkbrkalau : phk kalau
tida : tidak
niiiiiih : ini
mkan : makan
bnyak : banyak
nganggurbrbroke : nganggur oke
siihsdh : sih sudah
kurupdi : korupsi
selana : selama
kebutihan : kebutuhan 
bsyarkan : bayarkan
kebituhsn : kebutuhan 
zdolim : zolim
barangbrsimpelkan : barang simpelkan
krnapa : kenapa
mausysah : mau susah
fi : di
prsiden : presiden
kopeten : kompeten
eksfort : effort
ihsg : indeks harga saham gabungan
banysk : banyak
omonkphk : phk
bsu : bantuan subsidi upah 
riel : asli
asntnipolripensiunanpppk : asn tni porli pensiunan pppk
pemilupilprespilkada : pemilu pilpres pilkada
bkin : bikin
spya : supaya
boong : bohong
hatttttduh : aduh
ko : kok
seng : yang
bentuksekaliyan : bentuk sekalian
wakilnx : wakilnya 
yaaabrklu : iya kalau
apabrsembarang : apa sembarang
opo : apa 
gellem : bersedia
itugk : itu tidak
gajibrbetul : gaji betul
preeeet : umpatan
inibrmacan : ini macan
kucink : kucing
phkbgmn : phk bagaimana
nich : ini
orng : orang
barangbarang : barang barang
karyawanpekerja : karyawan pekerja 
gajiupah : gaji upah
darimana : dari mana
siapapunselama : siapapun selama
high cost : berbiaya tinggi
economy : ekonomi
perijinan : perizinan
ruwet : rumit
fair : adil
sagas : satgas 
dhancok : umpatan
mentei : kementrian
penglembungan : penambahan jumlah
piye to : bagaimana ini
mank : memang
stgas : satgas
dama : dalam
simple : sederhana
ajaada : aja dah
boikotyg : boikot yang
umpbersiaplah : ump bersiaplah
rmhbrtak : rumah tak
mengeluhbrkalo : mengeluh kalau
yahbgmn : iya bagaimana
nyungsep : jatuh terpuruk
gajisiapkan : gaji siapkan
dongrakyat : dong rakyat 
habishabisan : habis habisam
ngefek : berpengaruh
omon omon : omong-omong
bulshitt : umpatan
buruhdari : buruh dari
boro : boro boro
oh my god : astaga
rb: ribu, anburuh : buruh
ajah : aja
gtbrsedang : begitu sedang
pda : pada
duwit : uang
dikorup : dikorupsi
omon omon : omongan
ginikita : begini kita
china : cina
masukbrbrjelas : masuk jelas
saingbrharus : saing harus
klenger : nangis
usahagmn : usaha bagaimana
tutupitu : tutup itu
karyawanpegawainya : karyawan pagawainya 
cukupbrbiar : cukup biar
cri : cari
klau : kalau
monggo : silakan 
corporasi : koperasi
amsyoong : ancur
dipersulithpp : dipersulit hpp
berkeliaranpemerintah : berkeliaran pemerintah
matainvestor : mata investor
mahalwajar : mahal wajar
naikyg : naik yang
bli : beli
jta : juta
mkin : makin
murahbrdisana : murah disana
hartabrsedang : harta sedang
kelaparanbrmending : kelaparan mending
jawaquotegpquot : jawa
tropistidak : tropis tidak
dinginpanasataupun : dingin panas satupun
tsbnamun : namun
rataquot : rata
inibulan : ini bulan
lagibrapa : lagi berapa
brbrjika : jika
jamminggu : jam minggu
ajh : aja
naikbrbrbrbrkebijakan : naik kebijakan
sebelahbrbrada : sebelah rada
pemerintahya : pemerintah
penguasahwajar : penguasaha wajar
ngomng: ngomong nyapasti : nya pasti
nggk : tidak
kenytaanya : kenyataan 
outsrch : outsourcing
smnggu : seminggu 
kerjax : kerja
mengontrolbr : mengontrol
barangbr : barang
pajakbrlogika : pajak logika
krna : karena
indonesian : indonesia
bukakarena : buka karena
realistisingat : realistis singkat
triliunanyusril : triliunan yusril
tehbukti : terbukti
do : di
pengusahajgn : pengusaha jangan
sembronojika : sembrono jika
out : keluar 
siapquot : siap
frugal living : gaya hidup sederhana
anjing : umpatan
panjanglebar : panjang lebar
ptg : penting
tolol : umpatan
silahkn : silahkan
agkat : angkat
inibrtdk : ini tidak
negarabrpara : negara para
cum : hanya
terjajahbrmalah : terjajah malah
enk : enak
now : sekarang
watching : menonton
hdup : hidup
layakbru : layak baru
ogkag : ongkang 
brbanyakin : banyakin
depopulasibrhidup : depopulasi hidup
bgslah : baguslah
bergelimpangansmoga : bergelimpangan semoga
bsemua : semua
and : dan
masukb : masuk
naek : naik
phkcoba : phk coba
koreadi : korea di
produksipunglipajek : biaya produksi pungutan pajak
naek : naik
mk : maka 
meningkatkn : meningkatkan
beliquotbrsetuju : beli setuju
china : cina
smpe : sampai
survive : bertahan hidup
bangkruttt : bangkrut
perusahaanpengusaha : perusahaan pengusaha
orangquot : orang
amp : sampai
krna : karena
biadab : umpatan
gede : besar
pegainya : pegawai
sndri : sendiri
fee : upah
kwkwkw : tertawa
gaak : tidak
asingbrdan : asing dan
bisaaa : bisa
nyanggah : sanggah
vietnammenuju : vietnam menuju
bulshit : umpatan
buruhbrlupa : buruh lupa
terjd : terjadi 
hrg : harga
sdangkn : sedangkan
sayaalhmdllh : saya alhamdulilah
cuuyy : cuy
ajah : aja
brbrsalam : salam
sehatbrsalam : sehat salam
dangk t: diangkat
iti : itu
hti : hati
pdhalnyatanya : padahal kenyataannya
masyarakt : masyarakat
merekasda : mereka sudah 
banggah : bangga
astagah : astaga
cma : cuma 
siapquot : siap 
cost : biaya
garaquot : gara 
th : tahu 
krg : kurang 
benerquot : benar
janhan : jangan
mklum : maklum
pngusaha : pengusaha
dsini : disini
bnya : banyak
pabrikquot : pabrik
pingin : ingin
th : tahun
wong cilik : rakyat kecil
makankrna : makan karena
kecilgaji : kecil gaji
lautudara : laut udara
tehnologi : teknologi
smga : semoga
thun : tahun
dpan : depan
bneran : benaran
naikaq : naik
kerj : kerja
jkartasmua : jakarta semua
brsemoga : semoga
apa : bapak
kemenongmenong : orang jawa tengah
wong jowo : orang jawa
amp : sementara
orsun : orang sunda
dikiiittt : dikit
bingit : banget
masig : masih
brdijakarta : di jakarta
tikarbahkan : tikar bahkan
expor : export
maenkocak : main kocak
murahpadahal : murah padahal
mahalnyatapi : mahalnya tapi
adilbrgaji : adil gaji
teruss : terus
kansusah : kan susah
pilpreshahaha : pilpres tertawa
patenternyata : paten ternyata
umrump : ump
naikanni : dinaikan
al : alhasil
kitak : kita
bpbrberangkat : berangkat
quotquotmerekaquotquotquot: mereka
dkibrkan : dikibarkan
olokquot : olok olok
garaquot : gara gara
umpbrharusnya : ump harusnya
dkibrklw : dikibarkan
brtapi : tapi
fitnahbrhayo : fitnah ayo
haddeh : hadeh
sja : saja
honorr : honor
gji : gaji
rbu : ribu
dsyukiri : disyukuri
selatanharga : selatan harga
samabiaya : sama biaya
unp : ump
bgai : bagai
ngefekyg : ngefek yang
dubebani : dibebani
sprt : seperti
dcicill : dicicil
naikk : naik
persenyg : persen yang
hujattolong : hujat tolong
usa : usah
naikkanapalagi : naikkan apalagi
koarjelekkanboemerintah : koar jelekkan pemerintah
bakibat : akibat
wong : orang
quotlicikquotb : licik
jgan : jangan
mampussssssd : umpatan
dinaekin : dinaikkan
angel : susah
wisgaji : walaupun gaji
sepetil : sedikit
urip : hidup
brbrutk : untuk
brbrkudus : kudus
naikquot : naik
wuiiihhhhh : wow
naikbarang : naik barang
lakubrharga : laku harga 
rendahoperasional : rendah operasional
allooh : allah
naiksementara : naik sementara
bersyukurbrbagaimana : bersyukur bagaimana
wis : sudah
wae : saja
gadi : gaji
broooo : saudara
sendiriii : sendiri
hiungan : hitungan
ngk : tidak
terendahdgn : terendah dengan
desapdhl : desa padahal
hdp : hidup
tinggipajak : tinggi pajak
manabiaya : mana biaya
manamalah : mana malah
bedanyajd : bedanya jadi
rezekiyg : rezeki yang
nahh : nah
wkwkwkw : tertawa
disanabrst : disana
comment : komentar
ajib : hebat
tengsh : tengah
ajamaunya : aja maunya
indonesiadia : indonesia dia
mreka : mereka
sajaquot : saja
mirissss : miris
imporkirim : import kirim
pekerjaananeh : pekerja aneh
kep : kepada
president : presiden
naekan : naikkan
sulitbrjika : sulit jika
itubrbereskan : itu bereskan
blom : belum
iru : itu
naiksemua : naik semua
lakilaki : laki laki
kmrin : kemarin
protesny : protesnya
naikhpp : naik hpp
brkapan : kapan
just : hanya
watch : menonton
dimengertiquot : dimengerti
pesangonbrbr : pesangon
brbrupah : upah
thnan : tahunan
searching : mencari
lawakbryg : lawak yg
drpada : daripada
prodak : produk
produksibrbenci : produksi benci
upahpdahal : upah padahal
rakyatbrpayah : rakyat payah
menengahbrkalau : menengah kalau
melaksabakan : melaksanakan
brkarna : karena
credit : kredit
kendaraanbayar : kendaraan bayar
ful : full
awass : awas
umpbruang : ump uang
nantibrbrkebijakan : nanti kebijakan
commentbrsemoga : komen semoga
vanyak : banyak
gahi : gaji
brmasah : masih
konsepe : konsepnya
seprti : seperti
itupajak : itu pajak
naikgaji : naik gaji
tmpat : tempat
krja : kerja
pemerintahkenaikan : pemerintah kenaikan
atasantpi : atasan tapi
minimumbahkan : minimum bahkan
monggo : silakan
siapbahan : siap bahan
ditokobrkalau : di toko kalau
jutabruntuk : juta untuk
wawancaraiyg : wawancarai yg
tokobrnyatanya : toko nyatanya
jakartabrmasih : jakarta masih
begitugak : begitu tidak
nyaya : nya
nai : naikkan
kyknya : sepertinya
kbijakan : kebijakan
boss : bos
dimanajangan : dimana jangan
pemerintahguru : pemerintah guru
ptbumnbumd : pt bumn bumd
kabupatenumk : kabupaten umk
pentingkarena : penting karena
bawahsebab : bawah sebab
dllgaji : dll gaji
cukuplihat : cukup lihat
trilyunanitu : trilyunan itu
kerjasiapa : kerja siapa
banyakkalau : banyak kalau
kekaryawan : ke karyawan
manupakturbrminimal : manufaktur minimal
pengusahadibilang : pengusaha dibilang
gede : besar
bermerknaikin : bermerk naikin 
ampunharusnya : ampun harusnya 
jadibrgaji : jadi gaji
jutabrgaji : juta gaji
jutabrtotal : juta total
brjadi : jadi
tetep : tetap
tokoku : toko saya 
tdr : tidur 
embat : dihabiskan
gajk : gaji
naekin : naikkan 
woyyy : woy 
banggetbos : banget bos
judulnyabrbrquotump : judulnya
naikquotbrbrpajak : naik pajak 
boncos : rugi
kelontong : serba ada
wkwkwkwkwkw : tertawa
pungli : pungut ilegal 
all : semua
pengudaha : pengusaha 
jjangan : jangan 
prngangguran : pengangguran
brmirisnya : mirisnya
yaaaa : iya
gimna : bagaimana 
adakl : ada kalau
mn : mana 
pengusahakrn : pengusaha karena 
phkbrmstiny : phk mestinya 
carut marut : umpatan 
ginibrtp : begini tapi 
miskinkrn : miskin karena 
bodohin : dibodohkan 
manfaatkn : manfaatkan 
sasaranbrnegara : sasaran negara
apindonaik : apindo naik
ko : kok
kebutuhanpokok : kebutuhan pokok
sekrg : sekarang 
dimngimn : dimana mana 
dinaikinapalagi : dinaikkan lagi 
bsrnggak : tidak 
amp : sampai 
krjbaik : kerja baik 
pekerjahrs : pekerja harus
sudak : sudah
upahgaji : upah gaji 
naikx : naik 
tinggix : tinggi
tpsayang : tapi sayang
bukpak : ibu dan bapak 
kadesnya : kepala desanya
tlg : tolong 
kades : kepala desa 
paksekadang : bapak sedangkan 
pakbuk : bapak dan ibu
hidupdari : hidup dari
halobapak : halo bapak 
swastamari : swasta mari 
kitaspy : kita supaya 
pengsiun : pensiun 
pemerinyah : pemerintah
prabowotolonglah : prabowo tolonglah 
pengsiun : pensiun 
pengsiunan : pensiunan
kasihbrbantuan : kasih bantuan 
aktip : aktif
brdan : dan 
blkasih : kasih 
brmau : mau 
man : mana 
ngatur : mengatur
ri : republik indonesia
allham dulliah : alhamdulillah
per : bapak
dapetnya : dapatnya
seduniaguru : sedunia guru 
jgasn : jangan 
non : yang bukan
agr : agar 
hdp : hidup
amin : aamiin
laen : lain 
ngak : tidak 
bada : beda
naro : taruh 
wkakaka : tertawa
pj : penangung jawab 
sinting : gila 
naikin, pasukin
kmn : kemana
pabriknyaatau : pabriknya atau
brsaranbrgaji : saran gaji 
naek : naik 
brmksh : terima kasih
bqoak : bapak 
prabuwo : prabowo 
nsiksn : naikkan 
sata : saya
busa : bisa 
bang : bank
sang : sangat
minguan : mingguan 
ribusetiap : ribu setiap
sepayetmana : sepayet mana
dibicarakanump : dibicarakan ump
kesehatanaamiin : kesehatan aamiin
pak : bapak
persiden : presiden
prabowa : prabowo
haru : harus 
lebi : lebih
sejatra : sejahtera 
thun : tahun
tolng : tolong 
stap : staf 
nerima : menerima 
pamerentah : pemerintah
pr : 
hrpquot : 
nihilnikmatin : nihil nikmatkan 
berbhng : berbohong 
bhng : bohong
alhamdulillahmakasih : alhamdulillah terima kasih 
ter laksana : terlaksana 
amiiin : aamiin
gemana : bagaimana 
selaluaamiinyr : selalu aamiin ya rabbal alamin
hatimudahan : hati mudah mudahan 
istikomah : istikomah 
aamin : aamiin
salahquot : salah
subiantokenapa : subianto kenapa
alhamdulliksh : alhamdulillah 
koarnya : berkata kata
amin : aamiin
yra : ya rabbal alamin
mdhquotan : 
assallamuallaikumythbpk : assalamualaikum yang terhormat bapak
hpresiden : presiden 
memperhayikan : memperhatikan
wacanasayaibusuamisaya : wacana saya ibu suami saya 
rmhsedang : rumah sedang
ngalami : mengalami 
aslam : asam lambung 
kronisbanyak : kronis banyak 
hutangkrn : hutang karena 
sakitmiskin : sakit miskin 
presidensuami : presiden suami 
samaquotsepuh : sama sepuh 
pensiunmohon ; pensiun mohon 
bansosx : bansos 
presidenmohon : presiden mohon 
membalaslanx : membalas 
surabayamanyar : surabaya 
sabranganblm : belum 
bansosgmn : bansos bagaimana 
rasax : rasa 
bantian : bantuan 
orangquotdpt : orang dapat 
melongo : terheran 
sajatrimakasih : saja terima kasih
naikan : naikkan
pamenta : peminta
koropsi : korupsi 
kaseh : kasih
tidal : tidak 
pengaudet : pengaudit
pnspolritni : pns polri tni 
sementar : sementara
maap : maaf 
sebelimnya : sebelumnya 
abak : ayah 
kx : kesekian kalinya
th : tahun 
tolooong : tolong 
allahsemoga : allah semoga 
kabulkn : kabulkan 
abaku : ayahku  
oak : pak 
branaku : anakku 
bejerja : bekerja 
lolostolong : tolong 
diloloskn : diloloskan 
mnjadi : menjadi 
des : desember 
kanjut : lanjut 
lanjutvtolong : lanjut tolong 
prediden : presiden 
diurusin : diuruskan 
thnbini : tahun ini 
aamikn : aamiin
terimah : terima
ditaekin : umpatan 
tindes : umpatan 
naek : naik
insaallah : inshaallah 
priode : periode
bohooooong : bohong
sdah : sudah
prank : bohongi
gaj : gaji 
turunkanjadi : turunkan jadi
naikklau : naik kalau 
hematkerja : hemat kerja 
bensinparkir : bensin parkir 
mahalmkn : mahal makan 
bekel : bekal
kayak : seperti
mndengar : mendengar
nagar : negara
swtaamiin : swt aamiin
yasyukuri : ya syukuri
duda : juga  
prawobosalam : prabowo salam
ngeprank : membohongi 
alhamdulillaa : alhamdulillah 
pemerinta : pemerintah
menaikan : menaikkan 
amin : aamiin
omonpmon : tidak peduli
aduuh : aduh 
tiduur : tidur 
gajihnya : gajinya  
gol : tujuan 
prusahaan : perusahaan
negeribrkasian : negeri kasihan 
melangitbrtidak : melangit tidak
corporate : korporat
gji : gaji 
sja : saja 
sementa : sementara
tolonh : tolong
tinjangan : tunjangan
paniang : panjang
mengapdi : mengabdi 
molai : mulai 
mintak : minta
alhmdullih : alhamdulillah 
mksh : terima kasih
asl : assalamualaikum
bagai mana : bagaimana 
masjit : masjid 
mks : terima kasih 
wsl : wasalam
terimakasihpemberitahuansamapedagangpasarhargaekonominaik : terima kasih pemberitahuan sama pedagang pasar harga ekonomi naik
pakgk : pak tidak
mantab : keren
tlg : tolong 
gji : gaji 
krj : kerja
jtblnjd : juta per bulan jadi 
tlg : tolong 
ketenaga jerjaan : ketenagakerjaan 
uph : upah 
konpensasinya : kompensasinya 
pktolong : pak tolong 
pakkkk : pak
sangatbrberter : sangat ber 
bp : bapak 
peresedenbrpra : presiden pra 
kesekolahankatanya : kesekolahan katanya
pakkk : pak
ngos ngos an : melelahkan
lh : lah 
terbuktiterealisasi : terbukti terealisasi 
ae : saja 
bansosdaripada : bansos daripada
besarran : besar besaran
pakgmana : bapak bagaimana 
rentalgak : rental tidak 
sekolh : sekolah
keributanmikirlagimikir : keributan mikir lagi mikir
kenabrphk : kena phk 
mandeg : berhenti 
mampubayar : mampu bayar 
upahburuhbrkondisi : upah buruh kondisi 
ganaik : tidak naik 
pensiyunan : pensiunan 
atu : kalau begitu
pensiyuna : pensiunan 
umppt : ump pt
pensiyunan : pensiunan	
presidennnn : presiden 
pakkkk : bapak
ngak : tidak 
ta : tidak
tepe : tempe 
bosku : dong
a href : 
wabarokatuhbrsedang : wabarokatuh sedang
brmasa : masa 
kotra : kota 
ecek : pura pura 
naikthr : naik thr
anblnburuh : an bulan buruh 
nganter : mengantar 
doank : saja
antambah : an tambah 
tnjangan : tunjangan
gedebnerquot : tidak betul
prosentasi : presentasi 
besaralias : besar alias 
adilbrsebaiknya : adil sebaiknya
seroua : serupa
hehehe : tertawa
jtbrlah : jt lah 
nelen : menelan 
komenannyabrintinya : komen nya intinya 
dahh : deh
jtbulan : jt bulan
piye to : bagaimana sih 
kasian : kasihan
doank : saja
siabrgaji : sia sia gaji
pbuatan : buatan 
pcumabrbrfundamntalnya : percuma fundamentalnya 
fundamntal : fundamental 
robohbrbr : rubuh
gajihbrump : gaji 
gde : besar 
passan : tidak memenuhi
tiapquot : tiap 
pergibrkarena : pergi karena 
ahir : air
hy : hanya 
da : ada 
py : punya 
tmbhan : tambahan
skrng : sekarang 
ujungquotnya : ujingnya
konyol : umpatan 
maaeeeeennnn : main
up : naikkan
smpe : sampai 
blom : belum 
mini : kecil 
umpnya : ump nya 
keb : kebutuhan
ora : tidak
sd : sampai dengan 
hehehehehhe : tertawa
sejawa : se jawa 
kpl : kepala
sepadaan : sepadan 
butuan : kebutuhan
separonya : setengahnya
smpe : sampai 
preseiden : presiden
gajo : gaji
amin : aamiin
orangorang : orang orang 
pinterpinter : pintar 
mainin : memainkan 
rakyatklo : rakyat kalau
doangkenyataan : doang kenyataannya 
full : penuh
krja : kerja 
ssah : susah susah
hamsyong : tertawa
quotudah : sudah
sihquot : sih
dinaikin : dinaikkan
manusiawikenaikan : manusiawi kenaikan 
besarppn : besar ppn 
omon omon : tidak peduli 
sajatangkap : saja tangkap 
joskalau : bagus kalau 
rokmini : rok mini
wowo : prabowo 
bankrut : bangkrut
daua : daya 
quotinformalquot : formal
dulubrtapi : dulu tapi
rp : 10
lainn : lain 
jauhhh : jauh
brkita : kita 
persentbrtp : beberapa persen tapi
mantab : keren
anjing : umpatan
iso : bisa 
sihudah : sudah 
naikdaya : naik daya 
berkuranggaji : berkurang gaji  
naiksiapquot : naik siap 
boncosgaji : boncos gaji
gede : besar
siapquot : siap 
ikt : ikut
mn : mana
terlaksanabrpns : terlaksana pns
naikbrpejabatnya : naik pejabatnya 
yach : iya
jtbulan : jt bulan 
lemburan : lembur
kabgowa : kabupaten gowa 
ptcipta : pt cipta 
naikbrterus : naik terus
perusahaannyapindah : perusahaannya pindah
brsemua : semua
perhatianjakarta : perhatian jakarta
ptquot : pt 
anakquot : anak 
outsourcing : alih daya
kiraquot : kira
nyampe : sampai
janganjangan : jangan jangan 
paktolong : bapak tolong 
itutidak : itu tidak 
pengawasansehingga : pengawasan sehingga  
separo : setengahnya 
tetapkanberani : tetapkan berani
per rotes : protes 
outsorcing : alih daya 
dipereteli : dihancurkan
sepah : ampas
outsourcing : alih daya 
perakapa : perak apa
sayangbruda : sayang sudah 
thncari : tahun cari 
susahhadehhhh : susah
ajgk : umpatan
dngan : dengan 
outsorchingbrbrtolong : alih daya tolong 
outsorching : alih daya
naikkgajih : naik gaji 
alhamdulileh : alhamdulillah
carut marut : umpatan
ambyaaaar : hancur
naekpikir : naik pikir 
logikakoq : logika kok 
menaikkkan : menaikkan 
pajaksekalipun : pajak sekalipun 
peeusahaan : perusahaan 
laun : lain 
menimpac : menimpa 
bawahgimana : bahwa bagaimana 
fiakal : fiskal
brump : ump 
naikbrtp : naik tapi 
tepatbrbrdisisi : tepat disisi 
naikbrbunga : naik bunga 
naikbrump : naik ump 
naikbrekonomi : naik ekonomi 
brbrmenurut : menurut 
pengurngan : pengurangan 
pekerjabrbrkalau : pekerja kalau
brdan : dan 
brpajak : pajak
nntinya : nantinya 
ajh : saja
ngeluhhhhh : mengeluh
jtapalagi : jt apalagi 
outsorcing : alih daya 
jtmirisyg : jt miris yang
outsourcing : alih daya 
autsourcing : alih daya 
omon omon : tidak peduli
atu : kalau begitu
outsorsing : alih daya 
bwah : bawah 
bbrapa : beberapa 
prsen : persen 
pmbayarannya : pembayarannya 
lngsung : langsung 
tnpa : tanpa 
pihk : pihak 
trnyata : ternyata 
jkrrta : jakarta 
kryawann : karyawan 
krj : kerja 
pemberitaanbrsedangkan : pemberitaan sedangkan 
nuduhada : menuduh ada
nggh : umpatan
ditandanda tanganibrperusahan : ditandatangani perusahaan
langsungbrbuka : langsung buka 
mentribrspy : mentri supaya
naikpajak : naik pajak 
pegawaikarna : pegawai karena
lehhh : 
ngenakin : mengenakkan
cuekin : diamkan
brpantesan : pantas
rido : ridho
pertamak : pertamax
isti : istri
besarquot : besar
naikpengusaha : naik pengusaha 
sajabnyak : saja banyak
alihakan : alih akan
phkitu : phk itu 
kerjabuat : kerja buat
protesalasan : protes asal
a href : 
kuwasai : kuasai
haduuhkenaikan : kenaikan 
tesjadi : tes jadi 
bodohbrbrpengusaha : bodoh pengusaha 
muter : berputar 
bisnispekerja : bisnis pekerja
wajarburuh : wajar buruh
adeuh : waduh
petanikrn : petani karena 
petanibukan : petani bukan
bhan : bahan
bhn : bahan
krja : kerja
naikbr : naik 
brbrppn : ppn 
kbutuhan : kebutuhan 
jgklw : juga kalau
doank : doang
admwalau skil : admin walau skil 
adminnyatetap : adminnya tetap 
lolosentah : lolos entah
perumahanharus : perumahan harus 
keputusanagar : keputusan agar 
pengusahadan : pengusaha dan
kga : tidak
wong : walau 
robotbrbrnaik : robot naik 
bngt : sekali 
gada : tidak ada
rodibrdri : rodi dari
pengusahacuma : pengusaha cuma 
taniibrskrh : tani sekarang 
asnbrasn : asn asn  
skrh : serakah 
petaniibrkami : petani kami 
pemrintah : pemerintah 
hrga : harga 
tanibrseprti : tani seperti 
karetjagung : karet jagung
sorga : surga
pritah : perintah 
pesiden : presiden 
jebot : dahulu 
prusaan : perusahaan 
mendingan : lebih baik 
karuan : betul
wkww : tertawa 
naek : naik
tetendah : terendah 
mncapai : mencapai 
pdahsl : padahal 
sssinfapur : singapur
a href :
lemburan : lembur
jtbulan : jt bulan
nanyak : nanya
masalll : masal
britu : berarti itu
phkok : phk 
dema : demo
piequot : bagaimana
pir : bagaimana
kok : sih 
ora : tidak 
menerinaik : menerima
slah : salah 
dinaikin : dinaikkan 
amin : aamiin
apaa : apa 
aowkwkkwk : tertawa
hmmmm : kebingungan
naikbrkapan : naik kapan
jebol : rusak
kenabrpajak : kena pajak 
kenabrppn : kena ppn
seemoogaa gaajiiiiiiiii saatpaaam naaiiiik juugaa : semoga gaji satpam naik juga
perna : pernah
presidenjgn : presiden jangan
daerahkita : daerah kita 
atastapi : atas tapi
buruhkarna : buruh karena 
naikanmasih : naikkan masih
sejahtrakan : sejahterakan 
prabowobrbrgaji : prabowo gaji 
brcoba : coba
ckup : cukup
rbu : ribu
selesaikn : selesaikan 
krna : karena 
ujungx : ujung
di syukuri : disyukuri
perhatikancoba : perhatikan coba
apalgi  : apalagi
parusahaan : perusahaan
dtanya : ditanya 
malh : malah  
stengah : setengah
turuning : turunin 
naek : naik 
teteup : tetap 
sayah : saya
turunsuka : turun suka 
pokokperusahaan : pokok perusahaan
sbener ya : sebenarnya 
krna : karena 
kebutuhn : kebutuhan 
smkin :semakin 
skrg : sekarang
di syukuri : disyukuri
waja : wajah
pajek : pajak
masyarakt : masyarakat 
bosmalah : bos malah 
menjdikan : menjadikan 
terbsr : terbesar 
nntinya : nantinya 
dbtuhkan : dibutuhkan 
masyarkt : masyarakat 
hnyalh : hanyalah 
menekn : menekan 
hrga : harga 
kbtuhan : kebutuhan 
masyrkt : masyarakat 
manffatkn : manfaatkan 
dya:daya 
adajgn : ada jangan 
mengandlkan : mengandalkan 
makmurkn : makmurkan
lho : loh
rotisingkong : roti singkong
berkurangbralhasil : kurang berhasil 
naikbrproduksi : naik produksi 
bayarbrdan : bayar dan
quotancaman  : ancaman 
phkquotdireksi : phk direksi
mulujalan : mulu jalan
ajabrtolong : aja tolong
buruhbelum : buruh belum 
lapangankarena : lapangan karena
hiduptrus : hidup terus
dimpr : di mpr 
amp : dan
tiap : setiap 
snggup : sanggup 
trjdi : terjadi 
sharusnya : seharusnya 
bnyak : banyak 
lh : lah 
brsyukur: bersyukur 
trgantung : tergantung 
mngatur : mengatur
boong : bohong
bnyak : banyak
gajibryang : gaji yang 
hasilnyabrya : hasilnya 
seharibrkalau : sehari kalau
ia : iya
se enaknya : seenaknya
bulsit : omong kosong 
brkalau : kalau 
beli nya : belinya 
conto : contoh 
gajikekuatan : gaji kekuatan 
upah nya : upahnya
naikotomatis : naik otomatis, naikkalau : naik kalau, naikgak : naik gak, di gaji ratusdi : digaji ratusan di
ditemapt : di tempat
perbulannasip : perbulan
dilapangan : di lapangan
langkahnyabrklo : langkahnya kalau 
peraturanbrkebijakan : peraturan kebijakan 
dahulubrmisal : dahulu misal 
stopmengurangi : stop mengurangi 
tkakurangdibatasi : tka kurang dibatasi 
eksporbrmasa : ekspor masa
di senengin : disenengin 
brhabis : habis
benere : bener, semuajgn : semua jangan
upahdan : upah dan 
masalkalian : masal kalian
quotngekorquot :  
wong : orang
judol : judi online
phkbrcoba : phk coba 
indonesiabiar : indonesia biar 
sendiribrbisa : sendiribrbisa
ngakbranda : nggak anda 
wajarbrjgn : wajar jangan 
sendirikaya : sendiri kaya
sesuwatu : sesuatu 
masarakat : masyarakat 
burulalu : buruh lalu
sembaku : sembako 
tida : tidak 
pemerentah: pemerintah 
supsidi : subsidi
oprasi : operasi
mendalamkami : mendalam kami 
seneng: senang 
buruhtapi : buruh tapi 
kawatir : khawatir
nyampek : sampai 
dihilangkankenaikan : dihilangkan kenaikan 
he he he : tertawa
naikburuh : naik buruh 
naiklha : naik lah 
ki kuli :kuli 
tanipd hal: tani padahal
iya elah : Yailah 
di gencet :ditindas 
hadeh: haduh
segansegan : segan segan 
seharihari : sehari hari 
samasama : sama sama 
di untung : menguntungkan
lapangangaji : lapangan gaji 
buruhpekerja : buruh pekerja 
buanyak : banyak 
iniapa : ini apa 
ditanggapidi menangkan : ditanggapi dimenangkan
mlh : malah 
kbnykn:kebanyakan 
prsahan : perusahaan 
krywan : karyawan 
dbwah : dibawah
kalu : kalau 
ngk :nggak
okbrkalo : ok kalau 
kongtek bio: china, phkbr:phk 
dasar mping : umpatan
blom : belum 
lainny : lainnya 
dikibulin : dibohongin 
wkwwkwk: hahaha
mudhn : Mudah mudahan 
aminbrbiar : amin agar 
ngaggur : nganggur
gx : tidak 
sekarangbrcocok : sekarang cocok 
lajangbrmakanya : lajang makanya 
lagibrkarena : lagi karena 
dikota : di kota
ngg : tidak 
sperti : seperti 
guruhati : guru hati
banyakbrkenaikan : banyak kenaikan 
nyabrboleh : nya boleh 
pedagangquot : pedangan 
mreka :mereka 
buruhkaryawan : buruh karyawan 
pengusahabrdan : pengusaha dan 
stopperketat : stop perketat 
indonesiabrjika : indonesia jika 
di beli :dibeli, brjangan: jangan 
akalakalan : akal akalan 
naikotomatis : naik otomatis
pemerinta : pemerintah 
supot : membantu 
jaman : zaman 
tauh : tahu 
bgimana : bagaimana 
cbayakngakn : banyak
rban : ribuan 
ketiryaelah : ketir yailah 
naek : naik 
mahjg :  
trsburuh : dan buruh
rb : ribu 
juta an : jutaan 
juta anblnburuh: jutaan perbulan buruh 
nganter : mengantar 
doank : saja
amp : dan
em be structure garda cebha brkpdythbpkibu  :   
haq : hak 
sakitbrkarena : sakit karena 
ps brmohon : mohon 
disampaikanbrcqsistem : disampaikan sistem 
inpormasi : informasi 
real kah : beneran 
or : atau 
tok kantoran : kantoran 
nasip : nasib
di perhatikn : diperhatikan 
kasian : kasihan
pabrikbrpa : pabrik berapa 
sendiritidak : sendiri tidak
bnyak : banyak 
yaelah : yailah
menaker : manaker 
ngemenk : ngomong
besarquotandan : besar dan 
perusahaanpabrik : perusahaan pabrik
lanjutkanbiar : lanjutkan biar 
pakudah : pak udah 
naikmakin : naik makin
dehbrorang : dah orang 
kagetbrkok : kaget kok 
internasionalbr : internasional
mala : malah 
cuan : uang 
disemua : di semua 
sistim : sistem
kayasedangkan : kaya sedangkan 
sengsaraini : sengsara ini
inflasibrkebutuhan : inflasi kebutuhan 
banyakbrproduk : banyak br produk 
lakubratau: laku atau 
konsumenbrbrini : konsumen ini
temantemanbrjangan : teman teman jangan 
naikbrai : naik, rbbulan : ribuan perbulan
njalok : meminta 
piro : berapa 
daporanmu : laporan mu 
ngeluhbrkena : mengeluh terkena 
phl :phk
alesan : alasan 
samasama : sama sama 
stabilkan : menstabilkan 
buruhpengangguran : buruh pengangguran 
bawan : bawaan, dalem : dalam
nrima : menerima 
kariyawan : karyawan 
wkwkwk : hahaha
masal : massal
ohk : phk
berkurangdan : berkurang dan 
mesejahterakan : menyejahterakan
naikk : naik
ngk : tidak
ber imbas : berimbas 
karyawanmenurutku : karyawan menurutku
umrbrbgmna : umr bagaimana 
hariansungguh : harian sungguh
brpa : berapa 
bayarmasa : bayar masa 
prediksimenghitung : prediksi menghitung 
mesejathrakan : menyejahterakan 
jurussancaman : jurus ancaman 
ttap : tetap
ngomporquotin : memanaskan
slah : salah
bangkurut : bangkrut 
ahirnya : akhirnya 
plonga plongo : kebingungan
tolol : umpatan 
brdibawah : di bawah 
bryang : yang
brdgn : dengan 
ekonomisnyabrkalo : ekonomisnya kalau 
lainbrmasih : lain masih 
kerjaataupun : kerja atau pun
kna : kena
berpikiruntuk : berpikir untuk 
orng : orang
naikpengusaha : naik pengusaha
loss : lega 
wess : sudah 
neg : kalau 
iso : bisa 
mundak e : naik lagi
oprasional : operasional 
gede : besar 
dng : dengan
gx : tidak
mesti : pasti
rakyatkalau : rakyat kalau
kalauu : kalau 
habiss : habis 
naikk : naik 
gajii : gaji 
teruss : lalu 
berartii : artinya 
etoss: etos 
efort : usaha 
iyaa : iya 
mintaa : minta
how about : bagaimana dengan 
buuuuuuuuu:bu
cukk : umpatan
kenaipan : kenaikan
sejaterajangan : sejahtera jangan 
ngakmasak : tidak 
bantuantapi : bantuan tapi 
dikasi: dikasih 
budal :budak
tiap : setiap 
umpbrkenapa : ump kenapa 
brblm : belum 
brbrapanya : berapa
akalaan : akalan
yaa : iya
nganggep : anggap
kebanyakanbrbrlahh : kebanyakan lah 
ancurbrtanggung : hancur yanggung 
mencoblos : menyoblos
seimbangbrkan : seimbang 
dlawan sama : dengan 
pajakquot : pajak 
dllbrbrblum : dan lain lain belum 
kmiskinan : kemiskinan
kalontidak : kalau tidak
nikmatinbanyak : nikmati banyak 
padakayak : pada seperti 
waegembel : saja umpatan
menjasdi : menjadi
lahbrlu pada : lah kalian 
kanbriyaudah : kan yasudah 
tololbrrejeki : umpatan rezeki 
ko: kok 
b a b i : umpatan
buruhukuran : buruh ukuran
kawanjgn : kawan jangan 
susahskrng : susah sekarang 
umpyg : ump yang 
krj : kerja 
hdp : hidup 
enakkmn : enak kemana
quotwaduh : waduh 
nihquotpajak : nih pajak 
nihya : nih iya 
udalah : sudahlah 
sajabrkita : saja kita 
produksibrkata : produksi kata 
karyawanburuh : karyawan buruh 
phkbrkata : phk kata 
buruhkaryawan : buruh karyawan 
brnaik : naik 
pinter : pintar 
perusahaanbrtapi : perusahaan tapi
mundake : kenaikan 
naike : menaikkan 
pajak nya : pajaknya
pindah kah : pindah ke 
jawamemanfaatkan : jawa memanfaatkan 
rendahhh : rendah
ppengusaha : pengusaha 
vietnan : vietnam
brbuat : berbuat
saria : sepertinya 
arenak : enak 
narek : mendapat 
braning: saya 
mh : mah 
weuh : tidak ada 
mere : memberi 
nyatu : menyatu 
ge : juga 
jeung: dan 
hulu asin : sulit 
nyeri ajig hate : sangat sakit
angkaketika : angka ketika
pengamgguran : pengangguran
singapore : singapura
naikin : menaikkan
pakbr : pak
cv haru : cv harus 
di sampaikan : disampaikan
ooo : o
kusus : khusus
alhamdulillahmksih : alhamdulillah terima kasih
pphbrnaik : pph naik 
sbko : sembako
yu : yuk
berpa : berapa 
naikanya : naiknya 
umpbahan : ump bahan 
pokokdll: pokok dan lain lain 
mkan : makan 
dlluntuk : dan lain lain untuk
an brbrrakyat : rakyat 
braliansi : aliansi 
aliansy : aliansi 
ray : rakyat
teramg : terang 
umkumpbrseharusnya : umk ump seharusnya
mnengahpd : menengah pada 
quotmigrenquot  kegnya: sakit kepala sepertinya 
dngar kbijak : mendengar kebijakan 
umrumpbahan : umr ump bahan
onlin : online 
mentribelum : menteri belum 
mentri : menteri
koroptor : koruptor 
joko wi : jokowi 
mbayar : membayar 
utangnya : hutangnya
bp : bapak 
baikdata : baik data 
smga : semoga 
nyamhn : nya mohon 
penghargaanumumnya : penghargaan umumnya 
nyatenaga : nya tenaga 
perhatianmksih : perhatian terima kasih
pecatphk : pecatphk 
terimakasih : terima kasih
bagai mana : bagaimana
economy : ekonomi 
brbelum : belum 
paprik : pabrik 
brjadi : jadi
baikbrdi susul: naik disusul
senjak : sejak 
ancuranvuran : ancur ancuran
indonesiapak : indonesia 
perhati : perhatian
segitusementara : segitu sementara
percumah : percuma 
sasaranbrpercumah : sasaran percuma 
mesti : harus 
brpercumah : percuma
ptsabho : pt sabho 
di pekerjakan : dipekerjakan
mbok ongkos : biaya
pengannguran : pengangguran
fakulatas : fakultas
riko lur : itu
seg : kalau 
mundak : naik 
wong : orang 
tetep : tetap
ko : kok
naikbrpajak : naik pajak 
naikbrpengangguran : naik pengangguran 
naikbrnonsense : naik tidak masuk akal
sosisial : sosial
kbutuhan : kebutuhan, naek : naik
gaes : teman teman
pemerntah : pemerintah 
inipak : ini pak 
nanyadi mana : nanya dimana 
bekerjaupah : bekerja upah 
kehaduranjd : kehadiran 
pakitulah : pak itulah 
terjadijd : terjadi jadi 
pakjawab : pak jawab
disawsta : di swasta 
segituquot : segitu
gimna : Bagaimana
jumatga : jumat tidak  
brmana : mana 
guruguru : guru guru
taserius : serius 
naya : nanya
mngadu : mengadu 
iklhas : ikhlas
caer : cair
rakyatkalau : rakyat kalau
terimakasih : terima kasih
alhamdulillahbrumk : alhamdulillah umk 
brbrkemungkinan : kemungkinan 
jutabralhamdulillah : juta alhamdulillah
ente : kamu 
naek : naik  
rb : ribuan 
mengaet : menggait 
standart : standar 
ngurusnya : mengurusnya
pakprabowo : pak prabowo 
ajan : akan, adala : adalah 
bertamba : bertambah 
seng sara : sengsara
pakpresiden : pak presiden 
pakmasih : pak masih 
di bawa : di bawah 
lagipakpresiden : lagi pak presiden
di samakan : disamakan
sodareeebrnanti : saudara nanti
untungmenyusaikan : untung menyesesuaikan
sntara : antara 
terrcapai : tercapai 
di keluarkan : dikeluarkan
masyarakatdan : masyarakat dan 
jugabrjika : juga jika 
jugaalternatifnya : juga alternatifnya 
ngiritdampaknya : irit dampaknya 
jugamasyarakat : juga masyarakat
omon omon : omongan
nangkepin : menangkap, jtsekarang: jutaan sekarang
korupsijudol : korupsi judol 
narkobasuap : narkoba suap
naikbbm : naik bbm 
naikdllsama : naik dan lain lain sama
sendri : sendiri 
peesidenluar : presiden luar
smoga : semoga
benarbrcoba : benar coba 
ajurrr : hancur
lolak lolok : bodoh
kelasss : keren
luarbiasa : luar biasa
di ajuka : diajukan 
persn : persen
babu : pembantu
dimanabrkirain : dimana mengira 
parahbrprabowo : parah prabowo 
hargabrbrnaikin : harga menaikkan 
jurangbrsenang : jurang senang
hahahappn : hahaha ppn 
juta an : jutaan 
aajh : saja
alhamdulilllahsemoga : alhamdulillah semoga
jta : jutaan 
brapa : berapa
prsiden : presiden
tmkash : terima kasih
rncna : rencana 
amat : sangat 
membhagiakan : membahagiakan 
kta : kita 
jdii : menjadi
mensejahterakan : menyejahterakan
pelaturan : peraturan 
berterimakasih : berterima kasih 
walawpun : walaupun 
sodarayg : saudara yang 
membutuhkn : membutuhkan 
amp : dan 
mentriyng : menteri yang 
di tugaskn : ditugaskan
pensium : pensium
brti : berarti
seneng : senang
tahunkarna : tahun karena
biasaterimakasih : biasa terima kasih
alloh : allah
guruserta : guru serta 
butuhtapi : buruh tapi 
di ingat : diingat 
negarakenaikan : negara kenaikan 
naiktapi : naik tapi 
korbanbahasa : korban bahasa
allahlah : allah lah 
rahmatnyapercaya : rahmatnya percaya 
berjln : berjalan 
hidupsemua : hidup semua 
dijln : di jalan
naikwlpn : naik walaupun 
syjos :  saya
pabrikpt : pabrik pt 
jtandi : jutaan di 
skrngmalah : sekarang malah 
bnyka : banyak 
ptalias : pt alias 
umpumkyg : ump umk yang 
bijaimedan : binjai medan 
sistim : sistem 
bapakibu : bapak ibu
kakakqu : kakak ku 
nempatin : menempatkan 
amp : dan 
ditempatibrtrus : ditempati lalu 
nguliahin : menguliahkan 
anaknirg : anak
keluargabrsekarang : keluarga sekarang 
anakquot : anak
kayabrkecuali : kaya kecuali
presidensemoga : presiden semoga 
di permudah : dipermudah
jos : mantap
china : cina
tikarpt: tikar 
sritek :  
di naikkan : dinaikkan
bekriybekriy : 
